#S######################################
#   ###########                  #######
### ########### ####### ######## #######
#               ####### ######## #######
########### ########### ######## #######
########### ########### ######## #######
####            ####                 ###
######## ########### ########### #######
######## ###########    ######## #######
#                ###### ######   #######
# ######### ########### ###### #########
# ######### ########### ###### #########
# #########                    #########
# ######### ################## #########
# ######### ################## #########
# ##                  ##################
# ######### ############################
# ######### ############################
#                                  #####
##################################E#####