#S##################
# # ########       #
#            ##### #
## ###### ## ##### #
## ###### ## ##### #
##           ##### #
## ### ##### ##### #
## ### ##### ##### #
## ### ##### ##### #
###### ##### ##### #
###### ##### ##### #
######           # #
##     ####### ### #
## ########### ### #
##             ### #
## ############### #
## ############### #
## ############### #
##                 #
##################E#