#S#############
#            ##
## ### ### ####
## ### ### ####
## ### ###   ##
## ### ### # ##
## ### ##### ##
##            #
## #### #######
##  ### #######
## #### #######
##      #######
#######       #
####### ##### #
#############E#