#S######################################
#   ###########                  #######
### ########### ####### ######## #######
#               ####### ######## #######
########### ########### ######## #######
########### ########### ######## #######
####            ####                 ###
######## ########### ########### ### ###
######## ###########    ######## ### ###
#                ###### ######   ### ###
# ######### ########### ###### ##### ###
# ######### ########### ###### ##### ###
# #########                    ##### ###
# ######### ######### #### ### ##### ###
# ######### ######### #### ###     # ###
# ##                  #### ####### # ###
# ######### ##############         E####
# ######### ###################### # ###
#                                    ###
########################################