#S##################
# # ########       #
#   ######## ##### #
##                 #
##  ## ## ## ##### #
##           ##### #
## ### ##### ##### #
## ### ##### ##### #
## ### ##### ##### #
###### ##### ##### #
###### ##### ##### #
######           # #
##     ####### ### #
## ########### ### #
##             ### #
## ############### #
## ############### #
## ############### #
##                 #
##E#################